─────────────────────┬──────────────────##────────────────────┬───────────────────
                     │                                        │                   
                                        Maze                                      
                     │                                        │                   
                     │                                        │                   
                     │                                        │                   
                     │                                        │                   
                     │                                        │                   
                     │                                        │                   
                     │                                        │                   
                     │                                        │                   
     Liars Dice      │                                        │                   
                     │                                        │     BattleShip    
                     #                                        #                   
                     #                                        #                   
                     │                                        │                   
                     │                                        │                   
                     │                                        │                   
                     │                                        │                   
                     │                                        │                   
                     │                                        │                   
                     │                                        │                   
                     │                                        │                   
                     │                                        │                   
                     │                                        │                   
                     │                                        │                   
                     │                                        │                   
                     │                                        │                   
─────────────────────┤                                        ├───────────────────
                     │                                        │                   
                     │                                        │                   
                     │                                        │                   
                     │                                        │                   
                     │                                        │                   
                     │                                        │                   
                     │                                        │                   
    BlackJack        │                                        │       CoinGame    
                     #                                        #                   
                     #                                        #                   
                     │                                        │                   
                     │                                        │                   
                     │                                        │                   
                     │                                        │                   
                     │                                        │                   
                     │                                        │                   
                     │                                        │                   
                     │                                        │                   
                     │                                        │                   
                     │                                        │                   
                     │                                        │                   
                     │                                        │                   
                     │                                        ├───────────────────
                     │                                        │                   
                     │                                        │                   
                     │                                        │                   
                     │                                        │                   
                     │                                        │                   
                     │                                        │                   
                     │                                        │                   
                     │                                        │                   
                     │                                        │                   
                     │                                        │                   
                     │                                        │                   
                     │                                        │                   
                     │                                        │                   
                     │                                        │                   
                     └────────────────####────────────────────┘                   